NO ./src/textures/regular_tiles.xpm
SO ./src/textures/regular_tiles.xpm
EA ./src/textures/green_tiles.xpm
WE ./src/textures/green_tiles.xpm

C 0,39,47
F 245,245,220


             1111111111111111111111111
             1000000000110000000000001
             1011000001110000000000001
        111111001000000000000000000001
11111111101100000111000000000000111111
100000000011000001110111111111111
11110111111111011100000010001
1111D111111111011101010010001
11000000110101011100000010001
100000000000000011000000D0001
10000000000000001101010010001
11000001110101011111011110S0111
11110111 1110101 101111010001
11111111 1111111 111111111111